argument -> arguments
string concatenation -> concatenating
function -> functions
call -> called
variable -> variables
float -> "floating point"
operator -> operators
integer -> integers
exception -> exceptions
code block -> "block of code"
return value -> returned returns return
function definition -> "defining a function"
execute -> executing
run -> running
logical operator -> "logical operators"
module -> modules
function -> functions
built-in function -> "built-in functions"
type -> types
expression -> expressions
statement -> statements
evaluation -> evaluate
dir -> "directory function"
comment -> comments
string -> strings
list -> lists
index -> indexing
slice -> slicing
syntax error -> "syntax errors"
runtime error -> "runtime errors"
logical error -> "logical errors"
positional argument -> "positional arguments"
keyword argument -> "keyword arguments"
decrement -> decrements